e e n e n
n n e n i
s n e n n
e i n e e
n e n e f