n e e f e
i n n e n
n e n n i
e n e e n
e n e n s