n e n s n
n e n n i
f e e e n
e n e n n
e i n n e